################
##....[]..[]..##
####@...[]....##
##......[]....##
##..##..[]....##
##......[]....##
##............##
################